NO ./resource/wall64.png
SO ./resource/flippedwall64.png
WE ./resource/wall64.png
EA ./resource/flippedwall64.png

F 0,0,0
C 10,10,10

11111111111111111
10000010D00000001
10001000100110001
11111111100010001
10000000000000001
1000000001D110001
10000010010010001
110K0111111110001
10000000D00000001
1E000000100000001
11111111111111111