NO ./resource/brick.png
SO ./resource/eagle.png
WE ./resource/greystone.png
EA ./resource/minecraft-bee.png

F 194,178,128
C 135,206,235

11111111111111111
10000000000000001
10000000000000001
10000000000000001
10000000000000001
10000000N00000001
10000000000000001
10000001110000001
10000001 10000001
10000001110000001
10000000000000001
11111111111111111