NO ./resource/wall64.png
SO ./resource/flippedwall64.png
WE ./resource/wall64.png
EA ./resource/flippedwall64.png

F 0,0,0
C 10,10,10

                       1111111
                       100001
                       10000100
11111111111111111      100001
10000010D00000001      100001
10001000100110001      100001
11111111100010001111111100001111111111111
101K100000000000D000000000000000000000001
1000000001D110001111111100000000000010001
10101000010010001      100000000001110001
11101111111110001      100000000000010001
10000000D00000001      111111111111110001
1E000000100000001                   10001
11111111111111111                   10001
                          111111111110001
                          100000000000001
                          111111111100001
                                   111111