11111111
10100001
10100001
10100001
10000001
10000101
1P000001
11111111