11111111
10100001
10100001
10100001
10000001
10000101
100P0001
11111111