NO ./resource/brick.png
SO ./resource/eagle.png
WE ./resource/greystone.png
EA ./resource/minecraft-bee.png

F 190,178,123
C 135,206,235

11111111111111111
10000000000000001
10000000000000001
10000000000000001
10000000000000001
10000000000000001
100000000N0000001
10000000000000001
10000000000000001
10000000000000001
10000000000000001
11111111111111111