NO ./resource/brick.png
SO ./resource/eagle.png
WE ./resource/greystone.png
EA ./resource/minecraft-bee.png


C 135,206,235

F 185,180,172

1111
1001
1N01
1111