NO ./resource/brick.png
SO ./resource/eagle.png
WE ./resource/greystone.png
EA ./resource/minecraft-bee.png

F 194,178,128
C 135,206,235

      111111111111111111
       10000000000000001
111111110000000000000001
100000000000000011111001
10000000000000001   1001
10000000N00000001   1001
10000000000000001   1111
10000001110000001
10000001 100000011111111111111111111
100000011100000000000000000000000001
100000000000000010000111111111111111
1111111111111111100001
                100001
                100001
                111111