NO ./resource/wall64.png
SO ./resource/greystone.png
WE ./resource/lava.png
EA ./resource/brick.png

F 190,178,123
C 135,206,235

11111111111111111
10000000000000001
10000000000110001
10000000000010001
10000000000000001
10000000E00000001
10000000000000001
100000000 0000001
10000000000000001
10000000100000001
11111111111111111